Year,Period,labor force participation rate,employment-population ratio,labor force,employment,unemployment,unemployment rate
1976,Jan,71.3,64.7,321579,291933,29646,9.2
1976,Feb,70.8,64.2,321323,291651,29672,9.2
1976,Mar,70.5,64,321400,291820,29580,9.2
1976,Apr,70.4,64.1,322625,293430,29195,9
1976,May,70.5,64.3,324425,295681,28744,8.9
1976,Jun,70.7,64.5,326591,298204,28387,8.7
1976,Jul,70.8,64.8,328735,300492,28243,8.6
1976,Aug,71,64.9,330696,302339,28357,8.6
1976,Sep,70.9,64.8,332594,303985,28609,8.6
1976,Oct,71,64.9,334508,305580,28928,8.6
1976,Nov,71,64.8,336491,307303,29188,8.7
1976,Dec,71.1,65,338492,309309,29183,8.6
1977,Jan,71.2,65.2,340562,311692,28870,8.5
1977,Feb,71.2,65.4,342693,314431,28262,8.2
1977,Mar,71.4,65.7,344696,317304,27392,7.9
1977,Apr,71.3,65.9,346504,320144,26360,7.6
1977,May,71.3,66.2,348097,322831,25266,7.3
1977,Jun,71.2,66.3,349554,325371,24183,6.9
1977,Jul,71.2,66.5,351062,327915,23147,6.6
1977,Aug,71.1,66.7,352740,330606,22134,6.3
1977,Sep,71.1,66.8,354609,333479,21130,6
1977,Oct,71,67,356553,336441,20112,5.6
1977,Nov,71,67.2,358473,339372,19101,5.3
1977,Dec,70.9,67.4,360338,342151,18187,5
1978,Jan,70.9,67.5,362135,344783,17352,4.8
1978,Feb,70.7,67.4,363893,347265,16628,4.6
1978,Mar,70.6,67.5,365735,349657,16078,4.4
1978,Apr,70.6,67.6,367713,351989,15724,4.3
1978,May,70.6,67.6,369854,354273,15581,4.2
1978,Jun,70.6,67.6,372141,356515,15626,4.2
1978,Jul,70.7,67.7,374448,358612,15836,4.2
1978,Aug,70.7,67.6,376752,360563,16189,4.3
1978,Sep,70.6,67.5,379085,362483,16602,4.4
1978,Oct,70.7,67.5,381532,364517,17015,4.5
1978,Nov,70.7,67.5,384106,366695,17411,4.5
1978,Dec,70.8,67.6,386633,368864,17769,4.6
1979,Jan,70.7,67.4,389030,370904,18126,4.7
1979,Feb,70.8,67.4,391350,372844,18506,4.7
1979,Mar,70.8,67.4,393641,374748,18893,4.8
1979,Apr,70.8,67.4,395934,376659,19275,4.9
1979,May,70.7,67.3,398307,378688,19619,4.9
1979,Jun,70.8,67.3,400766,380828,19938,5
1979,Jul,70.9,67.3,403309,383155,20154,5
1979,Aug,71,67.4,405881,385669,20212,5
1979,Sep,70.9,67.4,408379,388244,20135,4.9
1979,Oct,70.9,67.5,410721,390754,19967,4.9
1979,Nov,70.8,67.4,412953,393114,19839,4.8
1979,Dec,70.9,67.4,415183,395240,19943,4.8
1980,Jan,70.9,67.4,417418,396980,20438,4.9
1980,Feb,70.8,67.2,419692,398289,21403,5.1
1980,Mar,70.8,67,422129,399267,22862,5.4
1980,Apr,70.8,66.7,424777,400108,24669,5.8
1980,May,71,66.6,427585,401031,26554,6.2
1980,Jun,71.1,66.5,430425,402242,28183,6.5
1980,Jul,71.4,66.5,433130,403778,29352,6.8
1980,Aug,71.5,66.6,435650,405566,30084,6.9
1980,Sep,71.6,66.6,438029,407499,30530,7
1980,Oct,71.7,66.7,440370,409469,30901,7
1980,Nov,71.9,66.8,442811,411522,31289,7.1
1980,Dec,72,66.9,445577,413867,31710,7.1
1981,Jan,72.2,67.1,448671,416536,32135,7.2
1981,Feb,72.5,67.3,451788,419338,32450,7.2
1981,Mar,72.6,67.4,454632,422111,32521,7.2
1981,Apr,72.8,67.6,457010,424674,32336,7.1
1981,May,72.8,67.8,458890,426828,32062,7
1981,Jun,72.8,67.7,460528,428591,31937,6.9
1981,Jul,72.8,67.7,462239,430012,32227,7
1981,Aug,72.9,67.7,464177,431174,33003,7.1
1981,Sep,73,67.6,466393,432206,34187,7.3
1981,Oct,73.1,67.6,468849,433194,35655,7.6
1981,Nov,73.3,67.5,471336,433994,37342,7.9
1981,Dec,73.4,67.4,473692,434523,39169,8.3
1982,Jan,73.5,67.2,475856,434878,40978,8.6
1982,Feb,73.5,66.9,477822,435130,42692,8.9
1982,Mar,73.5,66.8,479524,435251,44273,9.2
1982,Apr,73.5,66.6,481007,435295,45712,9.5
1982,May,73.5,66.4,482266,435282,46984,9.7
1982,Jun,73.4,66.1,483262,435135,48127,10
1982,Jul,73.3,65.9,484072,434829,49243,10.2
1982,Aug,73.3,65.7,484832,434393,50439,10.4
1982,Sep,73.4,65.5,485612,433829,51783,10.7
1982,Oct,73.4,65.3,486353,433166,53187,10.9
1982,Nov,73.3,65.1,486913,432567,54346,11.2
1982,Dec,73.2,65,487080,432105,54975,11.3
1983,Jan,73.2,64.9,486892,431871,55021,11.3
1983,Feb,73.1,64.9,486556,432089,54467,11.2
1983,Mar,72.9,64.9,486263,432877,53386,11
1983,Apr,72.8,65,486222,434230,51992,10.7
1983,May,72.7,65.2,486538,436044,50494,10.4
1983,Jun,72.7,65.4,487148,438131,49017,10.1
1983,Jul,72.7,65.6,487858,440312,47546,9.7
1983,Aug,72.6,65.7,488433,442418,46015,9.4
1983,Sep,72.5,65.9,488768,444370,44398,9.1
1983,Oct,72.3,66,488957,446217,42740,8.7
1983,Nov,72.2,66.1,489198,448017,41181,8.4
1983,Dec,72.1,66.3,489707,449885,39822,8.1
1984,Jan,72,66.4,490589,451924,38665,7.9
1984,Feb,72,66.5,491906,454109,37797,7.7
1984,Mar,72.2,66.7,493658,456320,37338,7.6
1984,Apr,72.3,66.8,495665,458380,37285,7.5
1984,May,72.4,66.9,497792,460222,37570,7.5
1984,Jun,72.5,67,499822,461807,38015,7.6
1984,Jul,72.6,67,501602,463165,38437,7.7
1984,Aug,72.5,66.9,503169,464391,38778,7.7
1984,Sep,72.4,66.8,504590,465616,38974,7.7
1984,Oct,72.4,66.8,505953,466983,38970,7.7
1984,Nov,72.3,66.8,507454,468587,38867,7.7
1984,Dec,72.2,66.7,509192,470370,38822,7.6
1985,Jan,72.2,66.7,511049,472101,38948,7.6
1985,Feb,72.1,66.6,512792,473542,39250,7.7
1985,Mar,72,66.5,514146,474582,39564,7.7
1985,Apr,71.9,66.4,515042,475330,39712,7.7
1985,May,71.7,66.2,515586,475943,39643,7.7
1985,Jun,71.5,66,516039,476651,39388,7.6
1985,Jul,71.3,65.9,516661,477610,39051,7.6
1985,Aug,71.3,66,517570,478946,38624,7.5
1985,Sep,71.3,66.1,518707,480619,38088,7.3
1985,Oct,71.5,66.4,519937,482421,37516,7.2
1985,Nov,71.6,66.5,521086,484165,36921,7.1
1985,Dec,71.6,66.6,522057,485763,36294,7
1986,Jan,71.6,66.8,522929,487278,35651,6.8
1986,Feb,71.7,66.9,523921,488911,35010,6.7
1986,Mar,71.8,67.1,525255,490811,34444,6.6
1986,Apr,72,67.3,526988,492980,34008,6.5
1986,May,72.2,67.6,529017,495347,33670,6.4
1986,Jun,72.4,67.8,531263,497844,33419,6.3
1986,Jul,72.6,68.1,533549,500330,33219,6.2
1986,Aug,72.6,68.1,535747,502654,33093,6.2
1986,Sep,72.7,68.2,537861,504720,33141,6.2
1986,Oct,72.7,68.2,539910,506563,33347,6.2
1986,Nov,72.7,68.2,541845,508201,33644,6.2
1986,Dec,72.7,68.2,543785,509792,33993,6.3
1987,Jan,72.8,68.2,545769,511445,34324,6.3
1987,Feb,72.7,68.1,547689,513123,34566,6.3
1987,Mar,72.8,68.2,549580,514871,34709,6.3
1987,Apr,72.8,68.2,551472,516714,34758,6.3
1987,May,72.8,68.2,553349,518611,34738,6.3
1987,Jun,72.8,68.2,555215,520509,34706,6.3
1987,Jul,72.8,68.3,557177,522453,34724,6.2
1987,Aug,72.8,68.3,559252,524478,34774,6.2
1987,Sep,72.8,68.3,561388,526654,34734,6.2
1987,Oct,72.8,68.3,563471,528952,34519,6.1
1987,Nov,72.8,68.4,565462,531382,34080,6
1987,Dec,72.7,68.4,567270,533835,33435,5.9
1988,Jan,72.7,68.5,568920,536242,32678,5.7
1988,Feb,72.6,68.5,570614,538682,31932,5.6
1988,Mar,72.6,68.6,572424,541109,31315,5.5
1988,Apr,72.5,68.6,574434,543512,30922,5.4
1988,May,72.5,68.7,576670,545953,30717,5.3
1988,Jun,72.6,68.7,579009,548433,30576,5.3
1988,Jul,72.6,68.8,581285,550934,30351,5.2
1988,Aug,72.6,68.8,583438,553420,30018,5.1
1988,Sep,72.5,68.8,585521,555881,29640,5.1
1988,Oct,72.4,68.8,587521,558297,29224,5
1988,Nov,72.3,68.8,589420,560608,28812,4.9
1988,Dec,72.3,68.8,591235,562792,28443,4.8
1989,Jan,72.2,68.8,593002,564854,28148,4.7
1989,Feb,72.1,68.7,594693,566706,27987,4.7
1989,Mar,72,68.7,596348,568455,27893,4.7
1989,Apr,71.9,68.5,597962,570166,27796,4.6
1989,May,71.8,68.5,599593,571843,27750,4.6
1989,Jun,71.7,68.4,601382,573559,27823,4.6
1989,Jul,71.7,68.3,603308,575274,28034,4.6
1989,Aug,71.6,68.2,605359,577058,28301,4.7
1989,Sep,71.6,68.2,607523,579028,28495,4.7
1989,Oct,71.5,68.1,609887,581315,28572,4.7
1989,Nov,71.5,68.2,612464,583921,28543,4.7
1989,Dec,71.6,68.3,615166,586696,28470,4.6
1990,Jan,69.4,66.4,642262,613848,28414,4.4
1990,Feb,70.4,67.3,652283,623895,28388,4.4
1990,Mar,70.8,67.7,657121,628630,28491,4.3
1990,Apr,71.1,68,660429,631615,28814,4.4
1990,May,71.1,67.9,663374,634029,29345,4.4
1990,Jun,71.3,68.1,666226,636174,30052,4.5
1990,Jul,71.6,68.3,669162,638230,30932,4.6
1990,Aug,71.5,68.1,672174,640205,31969,4.8
1990,Sep,71.3,67.8,675063,641962,33101,4.9
1990,Oct,71.2,67.6,677803,643474,34329,5.1
1990,Nov,71,67.3,680562,644935,35627,5.2
1990,Dec,70.9,67.1,683460,646533,36927,5.4
1991,Jan,70.8,66.8,686491,648293,38198,5.6
1991,Feb,70.7,66.7,689632,650268,39364,5.7
1991,Mar,70.6,66.5,692630,652350,40280,5.8
1991,Apr,70.5,66.4,695226,654411,40815,5.9
1991,May,70.3,66.2,697417,656439,40978,5.9
1991,Jun,70.1,66,699341,658447,40894,5.8
1991,Jul,69.9,65.8,701158,660375,40783,5.8
1991,Aug,69.8,65.7,703096,662179,40917,5.8
1991,Sep,69.7,65.6,705438,663868,41570,5.9
1991,Oct,69.7,65.5,708111,665356,42755,6
1991,Nov,69.7,65.4,710875,666657,44218,6.2
1991,Dec,69.8,65.3,713515,667861,45654,6.4
1992,Jan,69.8,65.2,715946,669110,46836,6.5
1992,Feb,69.7,65.1,718214,670502,47712,6.6
1992,Mar,69.7,65.1,720506,672169,48337,6.7
1992,Apr,69.7,65,722946,674099,48847,6.8
1992,May,69.7,65,725401,676078,49323,6.8
1992,Jun,69.7,64.9,727777,677988,49789,6.8
1992,Jul,69.6,64.8,730090,679842,50248,6.9
1992,Aug,69.6,64.8,732320,681698,50622,6.9
1992,Sep,69.5,64.7,734469,683644,50825,6.9
1992,Oct,69.5,64.7,736739,685848,50891,6.9
1992,Nov,69.5,64.7,739227,688242,50985,6.9
1992,Dec,69.5,64.7,742011,690790,51221,6.9
1993,Jan,69.5,64.7,745239,693603,51636,6.9
1993,Feb,69.6,64.7,748921,696728,52193,7
1993,Mar,69.8,64.9,753018,700205,52813,7
1993,Apr,69.9,65,757401,704023,53378,7
1993,May,70.1,65.1,761877,708049,53828,7.1
1993,Jun,70.2,65.3,766261,712154,54107,7.1
1993,Jul,70.4,65.4,770273,716191,54082,7
1993,Aug,70.3,65.4,773912,720159,53753,6.9
1993,Sep,70.3,65.4,777461,724214,53247,6.8
1993,Oct,70.3,65.5,781131,728410,52721,6.7
1993,Nov,70.2,65.6,785042,732704,52338,6.7
1993,Dec,70.3,65.6,789210,737101,52109,6.6
1994,Jan,70.3,65.7,793383,741457,51926,6.5
1994,Feb,70.3,65.7,797215,745536,51679,6.5
1994,Mar,70.3,65.8,800589,749217,51372,6.4
1994,Apr,70.2,65.7,803602,752564,51038,6.4
1994,May,70.1,65.7,806507,755777,50730,6.3
1994,Jun,70,65.7,809572,759030,50542,6.2
1994,Jul,70,65.6,812977,762470,50507,6.2
1994,Aug,70,65.7,816613,766073,50540,6.2
1994,Sep,69.9,65.6,820201,769706,50495,6.2
1994,Oct,69.9,65.7,823534,773310,50224,6.1
1994,Nov,69.8,65.6,826626,776908,49718,6
1994,Dec,69.8,65.7,829418,780310,49108,5.9
1995,Jan,69.7,65.6,831889,783342,48547,5.8
1995,Feb,69.6,65.5,834278,786152,48126,5.8
1995,Mar,69.5,65.5,836783,788916,47867,5.7
1995,Apr,69.4,65.5,839481,791768,47713,5.7
1995,May,69.4,65.5,842471,794904,47567,5.6
1995,Jun,69.3,65.4,845768,798416,47352,5.6
1995,Jul,69.3,65.5,849365,802266,47099,5.5
1995,Aug,69.3,65.5,853133,806246,46887,5.5
1995,Sep,69.3,65.6,856892,810170,46722,5.5
1995,Oct,69.3,65.5,860499,813907,46592,5.4
1995,Nov,69.3,65.6,863855,817417,46438,5.4
1995,Dec,69.3,65.6,867094,820788,46306,5.3
1996,Jan,69.3,65.6,870461,824275,46186,5.3
1996,Feb,69.3,65.6,874105,828056,46049,5.3
1996,Mar,69.3,65.7,878101,832214,45887,5.2
1996,Apr,69.4,65.8,882492,836778,45714,5.2
1996,May,69.5,65.9,887225,841685,45540,5.1
1996,Jun,69.5,66,892139,846796,45343,5.1
1996,Jul,69.6,66.1,897098,851948,45150,5
1996,Aug,69.7,66.2,902027,857042,44985,5
1996,Sep,69.7,66.3,906675,861847,44828,4.9
1996,Oct,69.8,66.3,910898,866234,44664,4.9
1996,Nov,69.7,66.3,914796,870394,44402,4.9
1996,Dec,69.7,66.4,918574,874636,43938,4.8
1997,Jan,69.7,66.4,922463,879117,43346,4.7
1997,Feb,69.7,66.5,926624,883885,42739,4.6
1997,Mar,69.8,66.6,931123,889000,42123,4.5
1997,Apr,69.8,66.7,935972,894359,41613,4.4
1997,May,69.9,66.8,940971,899692,41279,4.4
1997,Jun,70,67,945915,904846,41069,4.3
1997,Jul,70,67,950694,909828,40866,4.3
1997,Aug,70.1,67.1,955336,914660,40676,4.3
1997,Sep,70.2,67.2,960054,919458,40596,4.2
1997,Oct,70,67,960651,919924,40727,4.2
1997,Nov,69.8,66.8,961403,920340,41063,4.3
1997,Dec,69.6,66.6,962307,920829,41478,4.3
1998,Jan,69.4,66.4,963366,921525,41841,4.3
1998,Feb,69.3,66.2,964544,922479,42065,4.4
1998,Mar,69.1,66.1,965702,923573,42129,4.4
1998,Apr,69.1,66.1,968803,926834,41969,4.3
1998,May,68.8,65.8,967598,925982,41616,4.3
1998,Jun,68.9,66,972729,931512,41217,4.2
1998,Jul,69,66.1,977761,936882,40879,4.2
1998,Aug,69.1,66.3,982659,942138,40521,4.1
1998,Sep,69.2,66.4,987398,947296,40102,4.1
1998,Oct,69.3,66.5,991864,952300,39564,4
1998,Nov,69.4,66.7,995975,956983,38992,3.9
1998,Dec,69.4,66.7,999743,961152,38591,3.9
1999,Jan,69.4,66.8,1003285,964841,38444,3.8
1999,Feb,69.5,66.8,1006835,968187,38648,3.8
1999,Mar,69.6,66.9,1010585,971380,39205,3.9
1999,Apr,69.6,66.9,1014556,974531,40025,3.9
1999,May,69.7,66.9,1018568,977626,40942,4
1999,Jun,69.7,66.9,1022457,980739,41718,4.1
1999,Jul,69.7,66.9,1026078,983909,42169,4.1
1999,Aug,69.7,66.9,1029422,987214,42208,4.1
1999,Sep,69.7,66.9,1032666,990777,41889,4.1
1999,Oct,69.8,67,1036115,994672,41443,4
1999,Nov,69.8,67,1040046,998984,41062,3.9
1999,Dec,69.9,67.1,1044374,1003530,40844,3.9
2000,Jan,69.9,67.2,1048870,1007988,40882,3.9
2000,Feb,70,67.3,1053251,1012120,41131,3.9
2000,Mar,70.1,67.3,1057299,1015788,41511,3.9
2000,Apr,70.3,67.6,1060995,1019028,41967,4
2000,May,70.3,67.5,1064454,1022010,42444,4
2000,Jun,70.3,67.5,1067871,1024845,43026,4
2000,Jul,70.3,67.4,1071444,1027679,43765,4.1
2000,Aug,70.3,67.4,1075476,1030790,44686,4.2
2000,Sep,70.4,67.4,1080030,1034296,45734,4.2
2000,Oct,70.5,67.5,1085010,1038180,46830,4.3
2000,Nov,70.6,67.5,1090188,1042157,48031,4.4
2000,Dec,70.7,67.5,1095217,1045870,49347,4.5
2001,Jan,70.8,67.5,1099598,1048953,50645,4.6
2001,Feb,70.8,67.5,1103074,1051286,51788,4.7
2001,Mar,70.7,67.4,1105674,1052888,52786,4.8
2001,Apr,70.7,67.2,1107606,1053881,53725,4.9
2001,May,70.5,67.1,1109352,1054604,54748,4.9
2001,Jun,70.4,66.9,1111300,1055337,55963,5
2001,Jul,70.4,66.8,1113746,1056285,57461,5.2
2001,Aug,70.4,66.6,1116526,1057209,59317,5.3
2001,Sep,70.3,66.5,1119335,1057937,61398,5.5
2001,Oct,70.3,66.3,1122018,1058611,63407,5.7
2001,Nov,70.2,66.2,1124320,1059301,65019,5.8
2001,Dec,70.2,66,1126262,1060173,66089,5.9
2002,Jan,70.1,65.9,1127970,1061341,66629,5.9
2002,Feb,70,65.8,1129405,1062671,66734,5.9
2002,Mar,69.8,65.7,1130577,1064062,66515,5.9
2002,Apr,69.7,65.7,1131648,1065636,66012,5.8
2002,May,69.6,65.6,1132733,1067427,65306,5.8
2002,Jun,69.5,65.5,1133856,1069391,64465,5.7
2002,Jul,69.3,65.4,1134916,1071236,63680,5.6
2002,Aug,69.2,65.4,1135935,1072869,63066,5.6
2002,Sep,69.1,65.3,1136979,1074275,62704,5.5
2002,Oct,68.9,65.1,1137876,1075294,62582,5.5
2002,Nov,68.8,65,1138723,1076155,62568,5.5
2002,Dec,68.6,64.9,1139620,1077130,62490,5.5
2003,Jan,68.5,64.8,1140824,1078469,62355,5.5
2003,Feb,68.5,64.7,1142496,1080294,62202,5.4
2003,Mar,68.4,64.7,1144406,1082404,62002,5.4
2003,Apr,68.3,64.7,1146247,1084395,61852,5.4
2003,May,68.3,64.6,1147822,1086007,61815,5.4
2003,Jun,68.2,64.5,1149241,1087432,61809,5.4
2003,Jul,68.1,64.4,1150665,1089097,61568,5.4
2003,Aug,67.9,64.3,1152200,1091261,60939,5.3
2003,Sep,67.8,64.3,1153973,1094058,59915,5.2
2003,Oct,67.7,64.2,1156108,1097432,58676,5.1
2003,Nov,67.6,64.2,1158519,1101069,57450,5
2003,Dec,67.5,64.2,1160955,1104598,56357,4.9
2004,Jan,67.4,64.2,1163180,1107754,55426,4.8
2004,Feb,67.3,64.2,1165251,1110585,54666,4.7
2004,Mar,67.2,64.1,1167541,1113440,54101,4.6
2004,Apr,67.2,64.1,1170127,1116534,53593,4.6
2004,May,67.1,64.1,1172939,1119945,52994,4.5
2004,Jun,67,64.1,1175947,1123666,52281,4.4
2004,Jul,67,64.1,1179137,1127564,51573,4.4
2004,Aug,67,64.1,1182474,1131457,51017,4.3
2004,Sep,67,64.1,1185922,1135183,50739,4.3
2004,Oct,67,64.1,1189438,1138683,50755,4.3
2004,Nov,67,64.1,1193034,1142139,50895,4.3
2004,Dec,67,64.2,1196891,1145822,51069,4.3
2005,Jan,67.1,64.2,1201124,1149962,51162,4.3
2005,Feb,67.2,64.3,1205680,1154565,51115,4.2
2005,Mar,67.2,64.4,1210546,1159620,50926,4.2
2005,Apr,67.3,64.5,1215779,1165081,50698,4.2
2005,May,67.5,64.7,1221363,1170797,50566,4.1
2005,Jun,67.6,64.8,1227044,1176365,50679,4.1
2005,Jul,67.7,64.9,1232503,1181486,51017,4.1
2005,Aug,67.8,65,1237385,1186098,51287,4.1
2005,Sep,67.8,65,1241575,1190337,51238,4.1
2005,Oct,67.7,65,1245346,1194538,50808,4.1
2005,Nov,67.7,65,1249182,1198920,50262,4
2005,Dec,67.7,65,1253457,1203581,49876,4
2006,Jan,67.8,65.1,1258441,1208656,49785,4
2006,Feb,67.9,65.2,1264123,1214044,50079,4
2006,Mar,68.1,65.4,1270318,1219558,50760,4
2006,Apr,68.2,65.5,1276714,1225043,51671,4
2006,May,68.4,65.6,1282975,1230505,52470,4.1
2006,Jun,68.5,65.7,1288880,1235957,52923,4.1
2006,Jul,68.6,65.8,1294646,1241605,53041,4.1
2006,Aug,68.8,66,1300611,1247515,53096,4.1
2006,Sep,68.9,66.1,1306774,1253515,53259,4.1
2006,Oct,69.1,66.3,1312862,1259390,53472,4.1
2006,Nov,69.2,66.4,1318570,1264827,53743,4.1
2006,Dec,69.3,66.5,1323560,1269442,54118,4.1
2007,Jan,69.3,66.5,1327708,1273015,54693,4.1
2007,Feb,69.4,66.5,1331183,1275701,55482,4.2
2007,Mar,69.3,66.4,1334075,1277645,56430,4.2
2007,Apr,69.3,66.3,1336648,1279106,57542,4.3
2007,May,69.3,66.2,1339270,1280394,58876,4.4
2007,Jun,69.3,66.2,1342122,1281753,60369,4.5
2007,Jul,69.3,66.1,1345169,1283216,61953,4.6
2007,Aug,69.3,66,1348473,1284830,63643,4.7
2007,Sep,69.4,66,1352002,1286632,65370,4.8
2007,Oct,69.4,66,1355515,1288393,67122,5
2007,Nov,69.5,66,1358745,1289934,68811,5.1
2007,Dec,69.5,65.9,1361625,1291127,70498,5.2
2008,Jan,69.5,65.9,1364101,1291670,72431,5.3
2008,Feb,69.6,65.7,1366231,1291488,74743,5.5
2008,Mar,69.5,65.6,1368224,1290616,77608,5.7
2008,Apr,69.5,65.4,1370126,1289063,81063,5.9
2008,May,69.5,65.2,1371914,1286907,85007,6.2
2008,Jun,69.5,65,1373585,1284291,89294,6.5
2008,Jul,69.5,64.7,1375054,1281173,93881,6.8
2008,Aug,69.4,64.5,1376217,1277347,98870,7.2
2008,Sep,69.4,64.2,1377125,1272537,104588,7.6
2008,Oct,69.4,63.8,1377911,1266591,111320,8.1
2008,Nov,69.4,63.4,1378359,1259504,118855,8.6
2008,Dec,69.3,62.9,1378215,1251597,126618,9.2
2009,Jan,69.2,62.5,1377435,1243320,134115,9.7
2009,Feb,69.1,62,1376206,1235176,141030,10.2
2009,Mar,69,61.6,1374816,1227786,147030,10.7
2009,Apr,68.8,61.2,1373429,1221385,152044,11.1
2009,May,68.7,60.9,1371955,1215496,156459,11.4
2009,Jun,68.6,60.5,1370321,1209700,160621,11.7
2009,Jul,68.4,60.2,1368177,1203710,164467,12
2009,Aug,68.2,59.8,1365329,1197462,167867,12.3
2009,Sep,68,59.5,1362186,1191275,170911,12.5
2009,Oct,67.8,59.1,1359279,1185525,173754,12.8
2009,Nov,67.6,58.8,1357494,1180770,176724,13
2009,Dec,67.6,58.6,1357344,1177391,179953,13.3
2010,Jan,67.6,58.5,1358406,1175465,182941,13.5
2010,Feb,67.6,58.4,1359771,1174541,185230,13.6
2010,Mar,67.6,58.4,1360604,1173988,186616,13.7
2010,Apr,65.6,56.6,1360595,1173507,187088,13.8
2010,May,65.5,56.5,1359713,1173032,186681,13.7
2010,Jun,65.4,56.5,1358272,1172324,185948,13.7
2010,Jul,65.3,56.4,1357070,1171332,185738,13.7
2010,Aug,65.3,56.3,1356662,1170347,186315,13.7
2010,Sep,65.2,56.2,1356846,1169573,187273,13.8
2010,Oct,65.2,56.2,1357352,1169345,188007,13.9
2010,Nov,65.2,56.2,1357786,1169711,188075,13.9
2010,Dec,65.2,56.2,1357880,1170535,187345,13.8
2011,Jan,65.1,56.2,1357776,1171682,186094,13.7
2011,Feb,65.1,56.2,1357524,1172858,184666,13.6
2011,Mar,65,56.3,1357202,1173836,183366,13.5
2011,Apr,65,56.3,1357102,1174492,182610,13.5
2011,May,65,56.3,1357610,1175043,182567,13.4
2011,Jun,65,56.3,1358808,1175945,182863,13.5
2011,Jul,65.1,56.3,1360553,1177623,182930,13.4
2011,Aug,65.1,56.4,1362462,1180132,182330,13.4
2011,Sep,65,56.4,1364043,1183282,180761,13.3
2011,Oct,65,56.5,1364991,1186737,178254,13.1
2011,Nov,64.9,56.6,1365040,1190017,175023,12.8
2011,Dec,64.8,56.7,1364376,1192847,171529,12.6
2012,Jan,64.7,56.7,1363603,1195245,168358,12.3
2012,Feb,64.6,56.7,1363319,1197373,165946,12.2
2012,Mar,64.5,56.7,1363757,1199248,164509,12.1
2012,Apr,64.5,56.8,1364616,1200986,163630,12
2012,May,64.5,56.8,1365728,1202977,162751,11.9
2012,Jun,64.4,56.8,1366798,1205447,161351,11.8
2012,Jul,64.4,56.9,1367483,1208382,159101,11.6
2012,Aug,64.3,57,1367955,1211574,156381,11.4
2012,Sep,64.3,57,1368573,1214739,153834,11.2
2012,Oct,64.2,57.1,1369063,1217434,151629,11.1
2012,Nov,64.1,57.1,1369310,1219490,149820,10.9
2012,Dec,64,57.1,1369233,1220968,148265,10.8
2013,Jan,64,57.1,1368931,1222071,146860,10.7
2013,Feb,63.9,57.1,1368771,1223325,145446,10.6
2013,Mar,63.8,57.1,1368999,1225232,143767,10.5
2013,Apr,63.8,57.2,1369806,1227979,141827,10.4
2013,May,63.8,57.3,1370943,1231067,139876,10.2
2013,Jun,63.8,57.3,1372012,1233932,138080,10.1
2013,Jul,63.7,57.4,1372712,1236337,136375,9.9
2013,Aug,63.6,57.4,1372608,1238307,134301,9.8
2013,Sep,63.5,57.4,1371772,1240084,131688,9.6
2013,Oct,63.3,57.4,1371166,1242032,129134,9.4
2013,Nov,63.2,57.4,1371342,1244462,126880,9.3
2013,Dec,63.2,57.4,1372217,1247354,124863,9.1
2014,Jan,63.2,57.5,1373421,1250571,122850,8.9
2014,Feb,63.1,57.6,1374578,1253863,120715,8.8
2014,Mar,63.1,57.7,1375605,1256934,118671,8.6
2014,Apr,63,57.7,1376354,1259583,116771,8.5
2014,May,63,57.7,1376943,1262099,114844,8.3
2014,Jun,62.9,57.8,1377865,1264946,112919,8.2
2014,Jul,62.9,57.8,1379296,1268140,111156,8.1
2014,Aug,62.9,57.9,1381318,1271663,109655,7.9
2014,Sep,62.9,58,1383739,1275356,108383,7.8
2014,Oct,62.9,58,1385877,1278928,106949,7.7
2014,Nov,62.8,58.1,1387386,1282078,105308,7.6
2014,Dec,62.8,58.1,1388719,1284896,103823,7.5
2015,Jan,62.7,58.1,1390075,1287564,102511,7.4
2015,Feb,62.7,58.1,1391547,1290189,101358,7.3
2015,Mar,62.7,58.2,1393136,1292980,100156,7.2
2015,Apr,62.7,58.2,1394785,1295937,98848,7.1
2015,May,62.6,58.3,1396200,1298740,97460,7
2015,Jun,62.6,58.3,1397085,1301068,96017,6.9
2015,Jul,62.5,58.3,1397589,1302948,94641,6.8
2015,Aug,62.4,58.2,1398013,1304599,93414,6.7
2015,Sep,62.3,58.2,1398568,1306362,92206,6.6
2015,Oct,62.3,58.2,1399703,1308661,91042,6.5
2015,Nov,62.2,58.2,1401563,1311565,89998,6.4
2015,Dec,62.2,58.3,1403650,1314754,88896,6.3
2016,Jan,62.2,58.3,1405588,1317857,87731,6.2
2016,Feb,62.2,58.4,1407222,1320668,86554,6.2
2016,Mar,62.2,58.4,1408473,1323153,85320,6.1
2016,Apr,62.1,58.4,1409538,1325445,84093,6
2016,May,62.1,58.4,1410785,1327774,83011,5.9
2016,Jun,62,58.4,1412384,1330298,82086,5.8
2016,Jul,62,58.5,1414241,1333032,81209,5.7
2016,Aug,62,58.5,1416277,1335898,80379,5.7
2016,Sep,62,58.5,1418474,1338773,79701,5.6
2016,Oct,62,58.5,1420709,1341689,79020,5.6
2016,Nov,61.9,58.5,1423131,1344990,78141,5.5
2016,Dec,62,58.6,1426046,1348939,77107,5.4
2017,Jan,62.2,58.8,1422626,1345895,76731,5.4
2017,Feb,62.3,59,1427127,1351001,76126,5.3
2017,Mar,62.4,59.1,1431411,1356268,75143,5.2
2017,Apr,62.4,59.2,1435347,1361526,73821,5.1
2017,May,62.5,59.4,1438906,1366662,72244,5
2017,Jun,62.6,59.5,1442180,1371436,70744,4.9
2017,Jul,62.6,59.6,1445520,1375795,69725,4.8
2017,Aug,62.6,59.6,1449012,1379704,69308,4.8
2017,Sep,62.7,59.7,1452637,1383214,69423,4.8
2017,Oct,62.7,59.7,1456539,1386589,69950,4.8
2017,Nov,62.8,59.7,1460795,1390016,70779,4.8
2017,Dec,62.9,59.8,1465560,1393994,71566,4.9
2018,Jan,63,59.9,1470869,1398904,71965,4.9
2018,Feb,63.1,60.1,1476446,1404901,71545,4.8
2018,Mar,63.2,60.3,1481564,1411555,70009,4.7
2018,Apr,63.3,60.4,1485423,1417957,67466,4.5
2018,May,63.3,60.6,1487956,1423421,64535,4.3
2018,Jun,63.3,60.6,1489801,1427861,61940,4.2
2018,Jul,63.2,60.7,1491725,1431447,60278,4
2018,Aug,63.2,60.7,1494685,1434660,60025,4
2018,Sep,63.3,60.7,1499101,1437959,61142,4.1
2018,Oct,63.4,60.7,1504832,1441672,63160,4.2
2018,Nov,63.6,60.8,1511457,1445949,65508,4.3
2018,Dec,63.7,60.9,1518368,1450701,67667,4.5
2019,Jan,63.9,61,1524671,1455672,68999,4.5
2019,Feb,64,61.1,1529558,1460711,68847,4.5
2019,Mar,64,61.2,1532659,1465634,67025,4.4
2019,Apr,64,61.3,1534364,1470507,63857,4.2
2019,May,63.9,61.4,1535456,1475161,60295,3.9
2019,Jun,63.8,61.5,1536954,1479463,57491,3.7
2019,Jul,63.8,61.5,1539584,1483347,56237,3.7
2019,Aug,63.9,61.5,1543567,1486905,56662,3.7
2019,Sep,64,61.6,1548847,1490624,58223,3.8
2019,Oct,64.1,61.6,1554200,1494334,59866,3.9
2019,Nov,64.1,61.7,1557632,1497511,60121,3.9
2019,Dec,64.1,61.6,1558067,1499069,58998,3.8
2020,Jan,63.9,61.5,1557061,1498319,58742,3.8
2020,Feb,63.8,61.3,1557556,1495176,62380,4
2020,Mar,63.4,58.4,1549483,1426039,123444,8
2020,Apr,58.2,41.6,1424442,1018117,406325,28.5
2020,May,55.6,42.6,1362621,1043396,319225,23.4
2020,Jun,60.6,49.4,1487179,1212146,275033,18.5
2020,Jul,61.4,51.1,1509304,1255208,254096,16.8
2020,Aug,61.4,52.3,1509581,1287179,222402,14.7
2020,Sep,61.8,53.4,1521245,1314409,206836,13.6
2020,Oct,61.5,54.1,1516600,1333401,183199,12.1
2020,Nov,61.5,54.6,1518249,1347817,170432,11.2
2020,Dec,61.6,55,1522404,1358304,164100,10.8
2021,Jan,61.5,55.2,1521871,1366383,155488,10.2
2021,Feb,61.5,55.5,1522506,1373549,148957,9.8
2021,Mar,61.4,55.7,1520768,1380648,140120,9.2
2021,Apr,61.2,55.9,1517479,1387207,130272,8.6
2021,May,60.9,56.1,1511383,1392756,118627,7.8
2021,Jun,60.6,56.2,1505986,1397365,108621,7.2
2021,Jul,60.2,56.3,1499187,1400892,98295,6.6
2021,Aug,59.9,56.3,1494247,1404189,90058,6
2021,Sep,59.7,56.4,1491008,1407253,83755,5.6
